S ##########################
# #             #          #
# # ########### ########## #
# # #    #   #             #
# # #### # # #### ##########
# # #    # # #             #
# # # #### ### ########### #
# # # #        #           #
#       ################## #
#########    # # #       # #
# #       #### # ####### # #
# # ### ###  # # #       # #
#   #       ##   # ##### # #
##### #######  # #     # # #
#     #       ## ## #### # #
# ##### #######     #      #
#       #       ############
####### #########        # #
#       #         ######## #
# ####### ###### ##   #    #
#         #         #   ## #
######################E#####