S #############
#        ## # #
# ### ## # ## #
# #    # # ## #
# #  # # # ####
# ## #####  ###
# #      #  ###
# # #  # #  # #
##### ####  # #
#   #         #
# #    # # #  #
# #    # # #  #
# #    # # #  E
#### #### #####
###############