S   ## #####
  ## ##   #####
# #  #    # ###
   #    ##  ###
 ##  ####   ###
    ####  # ###
##  ##   #  ###
  ### # # # ###
 ###### ##  ###
    ## # ## ###
###########E###
